111111
100001
10E001
10P0C1
111111