111111111111111111111111111111111111111111111111111111111111111111111111111
100000000000000000000000000000000000000000000000000000000000000000000000001
100000000000000000000000000000000000000000000000000000000000000000000000001
100000000000000000000000000000000000000000000000000000000000000000000000001
1000000000000000000000000000E000000000000000000000000000000C000000000000001
1000000000000000000000000000000000000000000000C0000000000000000000000000001
100000000000000000000000000000000000000000000000000000000000000000000000001
100000000000000000000000000000000000000000000000000000000000000000000000001
100000000000000000101000000000000000000000000000000000000000000000000000001
1000000000000000001C100000000000000000P00000000000C000000000000000000000001
100000000000000000111000000000000000000000000000000000000000000000000000001
100000000000000000000000000000000000000000000000000000000000000000000000001
100000000000000000000000000000000000000000000000000000000000000000000000001
100000000000000000000000000000000000C00000000000000000000000000000000000001
1000000000000000000C000000000000000000000000000000000000000C000000000000001
100000000000000000000000000000000000000000000000000000000000000000000000001
100000000000000000000000000000000000000000000000000000000000000000000000001
100000000000000000000000000000000000000000000000000000000000000000000000001
100000000000000000000000000000C00000000000000000000000000000000000000000001
100000000000000000000000000000000000000000000000000000000000000000000000001
100000000000000000000000000000000000000000000C00000000000000000000000000001
10000000000001C100000000000000000000000000000000000000000000000000000000001
100000000000011100000000000000000000000000000000000000000000000000000000001
100000000000000000000000000000000000000000000000000000000000000000000000001
100000000000000000000000000000000000000000000000000000000000000000000000111
100000000000000000000000000000000000000000000000000000000000000000000000101
100000000000000000000000000000000000000000000000000000000000000000000001001
111111111111111111111111111111111111111111111111111111111111111111111111111